#####
#t.##
#.b.#
#.p.#
#####
